  NO textures/greystone.xpm
SO textures/purplestone.xpm
WE textures/redbrick.xpm
EA textures/wood.xpm

F 220,100,0
C 255,30,0

        11111111111 11111111111111
        10000000001 10000000000001
        10110000011 10000000000001
        1001000000111000000000001111
11111111101100000111000000000000001
100000000011000001110111111111111111
11110111111111011100000010001
111011111111100111010100100011
11000000110101011100000011111
10000000000000001100000011
10000000E00000001101010011111
110000011101010111111111100111
11110111 1110101101 111010001
11111111 1111111111 111111111