NO ./textures/greystone.xpm

SO ./textures/purplestone.xpm
WE ./textures/redbrick.xpm
EA ./textures/wood.xpm

C 31,32,32
F 0,32,32



1111111111111
1000000000001
1000D00W00001
1111111111111