  NO textures/greystone.xpm
SO textures/purplestone.xpm
WE textures/redbrick.xpm
EA textures/wood.xpm

F 220,100,0
C 255,30,0

   1111
   10011
11100001
  10S1001
  101 101
  111 111 