  NO textures/greystone.xpm
SO textures/purplestone.xpm
WE textures/redbrick.xpm
EA textures/wood.xpm

F 220,100,0
C 255,30,0

1111111 11
1     1011
1  11   1
111111111