NO ./textures/greystone.xpm

SO ./textures/purplestone.xpm
WE ./textures/redbrick.xpm
EA ./textures/wood.xpm

F 220,100,0
C 225,30,0

111111
100301
100001
1100N1
111111
