NO ./textures/wall4.xpm

SO ./textures/wall1.xpm
WE ./textures/wall2.xpm
EA ./textures/wall3.xpm

F 220,100,0
C 225,30,0


111111
1D0001
100D01
1100N1
11111
